          #   ·      # #                                                                       #               #      #   #       
          ······························#  #          #         #  #                                                              
         #·   ·                        ·                           ··············································#                
          ·   ·                   # #  ·                           ·   #  #       #     # #            # #      ·                 
   #      ·   ·                        ·                   #       · #                   #·················#    ·                 
          ·   ·#         #           # ·                           ·                  #   ·          #    ·     ·#             #  
          ·   ·    #  #  ································································#·               ·     ·                 
        ##·   ·          ·             ·##                         ·      #             · ·     #   #     ·     ·                 
          ·   ·          ·      #      ·············#           # #········································     ·             #   
      #   ·  #···························          ·     #                              · ·           #   #  #  · #               
      ······················#   #      #·    #     ·   #   #  #              #    #     · ·           #         ·               # 
      ·   ·         ## # · ·    #       · #        ·    #                      # #    # · ·          #························#  #
#     ·   ·          #   · ·#          #·········································································       #    ·    
      ·   ·   #          · ·················································#           · ·           ·#        #     #      ·   #
      ·   ·          #   · ·· #      ## #         #·         # ##          ·            · ·           · #    #               ·    
      ·   ·              · ··           ························#  #       ·   #        ·#····································    
      ·   ·    #         ·#··#    # # # ·          ·           ·         # ·   ···························#                  #    
      ·   ·        #    #···················································   ·        ·             ·  ·                        
    # ·   ·             ·····································# ·    #      #   ·        ·             ·  ·         #            # 
      ·   ·             ·  ··           ·       #  ·#       ·  ·           ·····································#                 
      ·   ·   #         ·  ··           ·  # #     ·        ·  ·           ·   ·       #·   #         ·  ·     ·                  
      ·   ·#  ··#      #································································· #     #     ·  · #   ·         # #      
      ·   ·   ·····························#       ·# #     ·  ·#          ·   ·  #     #             ·  ·     ·                  
      ·   ·  #···      #   ··           · ·      # ·    #   ·  ·           ·  #·#                     ·  ·     ·                  
      ·   ·  #···  #       ··       #   · ·      ·······································#             ·  ·     ·                  
  #   ·#  ·   ···   #      ··        #  · ·      · ·        ·  · #         ·   ·    #  ·         #    ·  ·     ·                  
#     ·   ·   ···          ··           · ·      · ·        ·# ·    #      ·   ·       ·              ·# ·     ·       #       #  
      ·   ·   ···        # ··#          · ·      · ·        ·  ·    ···························#  #   ·  ·     ·              #  #
      ·   ·   ···#         ··           · ·      · ·     #  ·  ·    ·      ·   ·       · #   #·  #    ·  ·    #·         #        
      ·   ·   ···     #    ··   #       · ·     #· ·   #    ·  ·    ·      ·   ·       ·# #   ·#      ·# ·     ·                  
 #    · ##···················           · ·#     · ·        ·# · #  ·      ·   ·   #   ·      ·       ·  ·     ·                # 
  #   · ·············#     #·#      #   · ·      · ·        ·  ·    ·#  #  ·#  ·   ##  · #    ·     # ·  ·     ·       #          
      · ·     ···   ·       ·····················································#     ·      ·       ·  ·     ·     #            
      · ·     ···   ·       ··#  #      · ·      · ·        ·  · #  · #    ·   ··      ·      ·     # ·  ·  #  ·               #  
      · · #   ···  #·       ··          · ·      · ·     #  ·  ·    ·   #  ·  #··#     ·      ·   #   ·  · # # ·                # 
      · ·     ···  ·················#   ·#·      · ·#       ·##·    ·      ·   ··      ·      ·       ·  ·     ·                  
      ·#·     ···  ··       ··     ·##  · ·  #   ·#·        · ·····················································# #            
      · ·     ···  ··  #    ··     ·    · ·  ·································#··      ·      · #     ·  ·     ·  ·               
      ·#·········  ··      #····················································································  ·           #   
      ·  #    ·#·  ··        ·     ·    · ·  ·  #· ·        · ··#   ·    # · · ··      ·      ·       ·  ·     #  ·             # 
  #   ·       · ·  ··        ·#    ·#   · ·  · # · ·        · ··    ·      · · ··      ·    # ·      #·  ·    # # ·               
   #  ·      #······················    · ·# ·   ·#·        · ··    ·    # · · ··      ·      ·       ·  ·       #·      #       #
      ·         ·  ··    #   ·     #    · · #·   · ·        · ·· #  ·      · · ··   #  · #   #·       ·  ·     #  ·               
      ·        #····································        · ··    ·#    #· · ^·      ·    # ·       ·  ·        ·               
      ·#       #   ··#       ·     #    · ·  · # · #        · ··    ·      · ·  ·     #·  # # ·  #    ·  ·        ·        #      
      ·      #     ··        ·    #··················································# ·      ·       ·  ·     #  ·               
      ·            ··        ·     ·    · ·  ·   ·    ##    · ··    ·      · ·  ·   ·  ·      ·       ·  ·        ·               
      ·            ··        ·     · #  · ·  ·   ·          · ··    ·      · ·  ·   ·  ·      ·       ·  · #      ·     #  #    # 
#     ·            ··  #     ·     ·    · · #·  #·          · ··   #·   #  · ·  ·   ·  ·      ·       ·  ·      # ·      #        
 #    ·            ··        ·     ·    · ·  ·   ·          · ··    ·  #   · ·  ·   ·  ·      ·    #  ·  ·        ·     ##        
      ·     #      ··    #   ·     ·    · ·  ·   · #        ·#··    ·      · ·  ·  #· #·      ·#      ·  ·        ·            #  
      ·#  #        ··        ·     ·    · ·  ·   ·          · ··    · #  # · ·  · # ·  ·      ·    #  ·  ·        · #             
      ·            ··        ·     ·    · ·  ·   ·          · ··    · ········································#   ·               
  #   ·            ··        · #   · #  · ·  ·   · #        · ··   #······································   ·    ·   #           
  #   ·    #       ··        ·     ·    · ·  ·   · ···································#·      ·   #   · ##   ·    ·          #    
  #   ·     #      ··        ·     ·    · ·  ·  #· ·        · ··      ·    · ·  ·   ·· ·      ·       ·      ·    ·               
   # #···············       #·     ·#   · ·  ·  #··············································       ·   #  ·    ·  #            
             #     ·#        ·   # ·    · ·  ·     ·        · ··      ·    · ·  ·   ·· ·      #      #·      ·    ·               
              #    · #       ·   ························································································#        
              # #  · ········································································#      ##·      ·    ·     ·         
           #       · ·       ·  #· ·    · ·  ·     ·#      #· ··      ·   #· ·  ·   ·· ·    ·       # ·   #  ·#   ·     ·   #     
                 # · ·  #    ·  ·········································································#   ·    ·     ·#        
  #                · ·       ·  ·· ·    · ·  ·     ·        · ··      ·    · ·  ·   ·· ·    · #       · ·    ·    ·     ·         
#             #    · ·       ·  ·· ·  # ·#·  ·     ·        · ··      ·    · · #· # ·· ·#   ·         · ·    ·#   ·     ·         
         #  #   #  · · #     · #·· ·    · ·  ·     ·        · ··#     ·    · · #·   ·· · #  ·         · ·    ·    · #   ·  #      
     ##           #···························································································    ·#    ·     #   
 #         #         ·       ·  ·· ·    · ·  ·     ·        · ··##    ·    · ·  ·   ·· ·    ·  #   #  · ·    #    ·     ·         
            #        ·       ·  ·· ·    · · #·#    ·        · ··      ·    · ·  ·   ·· ·    · #       · ·         ·     ·     #   
                     ·       · #·· ·    · ·  ·    #·        · ··      ·    · ·# ·   ·· ·    ·         · ·         ·     ·    #    
 #          #    #   ·       · #·· · #  · ·  ·     ·       #· ··      ·    · ·  ·#  ·· ·    ·        #·············     ·      #  
                     ·       ·  ·· ·    · ·  ·     ·        ·#··      ·    · ·##·   ·· ·    · #         ·         #     ·         
                     ·    ## ·  ·· · #  · ·  ·     ·        · ··      ·    · ·  ·   ·· ·    · ························# ·         
        #  #         ·       ·  ·· ·   #················································    · ·         ·  #         ·  ·         
  #     #            ·       ·  ·· ·      ·  ·     ·        · ··      ·    ·#·  · # ·· #  # · ·   #     · #     #    ·# ·         
                     ·       ·  ·· ·#     · #·   # ·        · ··      ·    · ·  ·   ··  #   · ·         ·        #   ·  ·    #    
               #     ·       ·# ·· ·      ·  ·  #  ·        · ··#    #················································  · #       
    #                · #     ·  ·· ·      ·  ·  ··················································#     · #          #  ·         
  #                  · ·······························#     · ··      #    · ·  ·   ··      · ·  ·    # ·    #          ·     #   
       #            #· ·     ·  ·· ·      ·  ·  ·# · ·      · ··           · ·  ·   ··   #  ·#·  ·      ·         ##    ·         
                     · ·     · #·· ·   #  ·  ·  ·  · ·      · ··        #  · ·  ·   ·· #    · ·  ·      ·   #           ·         
                     · ·   # ·  ·· ·   ···································#· ·  ·   ·· ······························# #· #       
    #        #       · ·     ·  ··#··············································   ·· ·    · ·  ·      ·           ·   ·     #   
#                  # · ·     ·  ··     · #·  ·  ·  · ·      · ··         · · ·# #   ·· ·    ·#···········        #  ·   ·         
    #        #   #   · ·     ·  ··     ·  ·  ·# · #· ·      · ··         ·#· ·      ·· ·  # ·    · #    #           ·   ·         
                     · ·     ·  ··     ·  ·  ·  ·  · ·      · ··         · · ·      ·· ·    ·#   ·#               # ·#  ·         
         #          #·························································  # # ·· ·    ·    ·         #        ·   ·     #   
                       ·     ·  ··   # ·  ·  ·  ·  · ·#     · ··# #      · · ##     ·· ·    ·    ·   #  #           ·   ·         
     #  #              ·     ·  ··     ·  ·  ·  ·  · ·      · ··         · ·  # #   ·· ·    ·    ·               ## ·   ·         
                       ·     · #··  # #·  ·  ·  ·  · ·      · ··         · ·        ·· · # #·    ·                  ·#  ·     #   
#                      ·     ·  ··     ·##·  · #·  · ·      · ··         ·#· #      ·· ·    ·    ·#         #       ·  #·         
      # #             #·   ##···································         · ·        ·· ·    ·   #·               #  · # ·    #    
                  #   #······································ ·#         · ·        ·· ·    ·    ·      #   #       ·   ·         
                    #   #       ··  ## ·  ·  ·  ·  · ·   #  # ·  #       · ·        ·· ·    ·  # ·    #            #·   ·         
         #          ·······························································#·· ·    · #  ·                  ·   ·         
                    ·           ··    #··············································· ·    ·    ·        # # #     ·   ·        #
       #   #     #  ·     #     ··       #·  ·  ·  · ·    #   ·          · ·      · #·#······    ·# #             # ·   · #       
   #                ·#      #   ··      # ·  ·  ·  · ·#       ·          · ·      ·  ·      #    ·                  ·   ·         
 #                  ·       ·················································································#      ·   ·         
            #       ·  #    ·   ··        ·  · #······································           ·          ·       ·   ·  #    # 
      #    #   #    ·       ·   ··       #·  ·  #  · ·        ·        ##· · #    ·  #           ·         #·   #   ·   ·         
                    ·       ·   ··  #     ·  ·     · ·        ·#       # · ·   #  ·              ·          ·       · # ·      ## 
                   #··································        ·          · ·      ·              ·    #     ·       ·# #·         
    #                       ·  #···········  ·     · # #      ·  #   #   · ·#  #  · #            ·          ·       ·   ·         
                  #      #  ·    ·        #  ·     ·          ·          · ·      ·#   #        #·          ·       ·   ·         
                            ·  # ·       #   ·     ·          ·          · ·      ·         #    ·          ·       ·   ·         
                  #         ·    ·           ·     ·          ·  #       · ·     #·          #  #·          ·       ·   ·         
                           #······················································· #        #   ·          ·       ·   ·         
                 #       #       · ##        ·    #·  #    #  ·          · ·      #       #      ·          ·       ·   ·         
           #               #     ·           ·     ·  ··············································# #     ·       ·   ·         
           #          #          ·           ·   # ·  ·       ·        # · ·#         #          · ·      ##·  #    ·   ·#        
       #             #        #  ·           ·     ·  ·       ·          ·#··············································   # #   
                     #           ·           ·     ·  · # #   ·  #       ·           #           · ·        ·  #   #·   #  ##     
       #                   #     ·       #  #·     ·  ·       ·          ·                       · ·        ·  #    ·             
  #        #                     ·  #        ·   # ·# · #     ·          ·          #            · ·        ·       ·      # #    
                             #  #·      #    ·    #··························································       ·   ##   #    
              ##                #·           ·        ·  #    ·          ·                       · ·        #     # · #           
             #              #    · #         ·        ·       ·          ·                       ·#·                · #           
#   #            #           ##  ·          #·····························             #         · ·                ·             
                          #     #·                  # ·       ·          #                #      · ·                ·             
                                 ·                   #············································ ·                ·   #   #     
                  # #        #   ·# # #  #           ····································#     ### ·#               ·         #   
 #   #         #          #      ·                   ·        ·                         ·         #·#            #  ·         #   
   #                             ·#                  ·        · # #                     ·          ·           #    ·             
#                                ·               #  #···············································           #    ·          # #
                                 ·      #             #       ·      #               #  ·      #   #                ·             
                              #  ·              #             ·    #                #   · #       #          #      ·             
            #       #           #····················································································     #       
# #                              #                # #         ·         #               ·     #                     #      #      
     #  #       ##                                           #··························· #                                       
       #  #  #         #                          # #    #                          #   #                        #     #          
